99 10 1
########
#   #  #
#      #
## #. .#
#    ###
# # * # 
# $$# # 
###  @# 
  ##### 