1
############
#           #
#  $        ##
#  #   #     #
#   #   #    #
#    #   #   #
#     #   #  #
#  @         #
#            .#
##############
