1 99
#################
#.              #
#        #      #
##              #
#               #
#               #
#     @     #   #
#    $$       # #
#               #
#  #        .   #
#               #
#################
